#####################################################################  
##.. .....................................................  ......  ## 
##.. ################        ...     ##############  ###..   ####   ## 
##..        ###   ###     ###...     ###        ###  ###..    ###   ## 
##..              ###     ###...                ###  ###..    ###   ## 
##..        ########  . . ###...     ##############     ..   ####.  ## 
##..        ###       . . ###...    ............... ### ..       .  ## 
##..        ##########. . ###...    ############    ### ..   ####.  ## 
##..               ###.             ###......       ### ..    ###.  ## 
##..     ......... ###.             ###......###        ..    ###.  ## 
##..###  #########.###. ###            ......###        ..### ###.  ## 
##..###  ###   ###..    #############  ......###         .###.      ## 
##..###  ###   ###..           ...###     ######        . ###.      ## 
##..###            .           ...###               ### ..###.      ## 
##..###  #############         ...#############     ### ..########  ## 
##...............................................   ### ..........  ## 
##   ............................................          .......  ## 
##..###  ###   ###..    #############  ......###    ### ..###.      ## 
##..###  ###   ###..           ...###     ######    ### ..###.      ## 
##..###            .           ...###               ### ..###.      ## 
##..###  #############         ...#############     ### ..########  ## 
##...............................................   ### ..........  ## 
##  .............................................          .......  ## 
#####################################################################  
